00000000000000000000
00000000000004400000
00000000000000000000
33333330000000000000
00000000000020000000
00000002222200000000
01111110000000040000